Loan Amount (USD),Monthly Income (USD),Monthly Expenses (USD),Interest Rate (%),Disposable Income (USD),Monthly Installment (USD),Time to Repay (Months)
462498,21405,10710,8,10695,5611.38,43.24
205002,13601,4619,8,8982,2487.24,22.82
443293,5894,16975,4,-11081,4488.13,
175501,5514,15835,12,-10321,2517.93,
332755,28678,18261,12,10417,4774.07,31.94
198056,26288,4431,8,21857,2402.97,9.06
64060,29251,12067,8,17184,777.22,3.73
264057,9109,7713,4,1396,2673.45,189.15
355447,18258,12557,12,5701,5099.63,62.35
240279,20313,12435,4,7878,2432.71,30.5
256118,20349,7998,8,12351,3107.42,20.74
210359,12179,3162,12,9017,3018.04,23.33
89711,15326,4974,12,10352,1287.09,8.67
193026,16787,22675,8,-5888,2341.94,
385484,6560,11461,4,-4901,3902.84,
268134,18612,20015,4,-1403,2714.73,
152974,22650,20289,12,2361,2194.73,64.79
199646,25022,5014,8,20008,2422.26,9.98
452400,24811,12833,12,11978,6490.63,37.77
200168,9780,10896,8,-1116,2428.59,
117728,23311,3204,4,20107,1191.94,5.86
215088,16894,19965,8,-3071,2609.61,
61246,7356,12032,4,-4676,620.09,
488774,9790,8347,8,1443,5930.18,338.72
461597,21690,5643,12,16047,6622.58,28.77
439940,29363,11017,4,18346,4454.18,23.98
479671,25049,21681,12,3368,6881.89,142.42
142263,15181,20258,12,-5077,2041.06,
447234,12057,8560,4,3497,4528.03,127.89
61302,21082,18892,4,2190,620.65,27.99
379650,5661,17531,12,-11870,5446.87,
91157,9644,20073,12,-10429,1307.84,
104917,20711,7000,12,13711,1505.25,7.65
273810,29887,17289,12,12598,3928.38,21.73
146646,7920,20055,4,-12135,1484.72,
395266,21002,10927,4,10075,4001.88,39.23
336663,19025,18562,12,463,4830.14,727.13
393054,13946,4171,8,9775,4768.83,40.21
432574,17732,24975,8,-7243,5248.32,
383468,11236,14918,4,-3682,3882.43,
317552,21309,12135,12,9174,4555.95,34.61
109379,27462,9342,12,18120,1569.27,6.04
75053,18518,20833,4,-2315,759.88,
452662,5352,14929,8,-9577,5492.04,
181994,12005,5539,8,6466,2208.09,28.15
148723,19036,6959,8,12077,1804.42,12.31
101356,21542,16183,4,5359,1026.18,18.91
322933,5956,8432,8,-2476,3918.07,
409864,7071,23644,4,-16573,4149.67,
378800,13595,21745,4,-8150,3835.17,
356172,20140,23054,12,-2914,5110.03,
376628,17803,4753,8,13050,4569.54,28.86
82154,8453,21322,4,-12869,831.77,
263942,11675,13123,8,-1448,3202.34,
314480,5955,19376,8,-13421,3815.51,
415821,11295,9588,12,1707,5965.82,243.6
379923,20921,9304,8,11617,4609.51,32.7
331173,23096,10345,12,12751,4751.37,25.97
371345,20282,18352,4,1930,3759.69,192.41
82265,9703,3597,8,6106,998.1,13.47
415060,11563,22446,4,-10883,4202.28,
293322,27015,5336,8,21679,3558.81,13.53
224944,17003,12879,4,4124,2277.45,54.55
96197,15817,3572,8,12245,1167.14,7.86
437877,16171,10521,8,5650,5312.66,77.5
498396,17582,9171,8,8411,6046.92,59.26
204782,17201,21474,8,-4273,2484.57,
210558,22778,16992,8,5786,2554.65,36.39
121907,17473,14861,8,2612,1479.07,46.67
441020,14461,15464,8,-1003,5350.79,
252967,26116,24008,8,2108,3069.19,120.0
376579,25098,4633,8,20465,4568.94,18.4
352775,20596,20901,4,-305,3571.68,
441182,5529,15485,12,-9956,6329.68,
282604,24342,13849,8,10493,3428.77,26.93
332247,29288,6648,12,22640,4766.78,14.68
114772,24975,18177,8,6798,1392.5,16.88
176108,28279,16140,8,12139,2136.68,14.51
64382,17765,20921,4,-3156,651.84,
134291,18910,17357,4,1553,1359.63,86.47
413339,16561,16368,12,193,5930.21,2141.65
184828,14131,6137,4,7994,1871.29,23.12
332753,5525,3097,4,2428,3368.96,137.05
197550,27861,14407,12,13454,2834.27,14.68
282050,21385,15722,4,5663,2855.62,49.81
482882,5374,15924,8,-10550,5858.69,
387827,17197,6750,12,10447,5564.19,37.12
436858,9648,11535,12,-1887,6267.64,
180330,7365,24797,8,-17432,2187.9,
121315,22909,7666,4,15243,1228.26,7.96
389978,6646,19009,12,-12363,5595.05,
438349,5013,19994,12,-14981,6289.03,
64153,9599,4727,8,4872,778.35,13.17
126325,7278,4854,8,2424,1532.67,52.11
290773,19296,13800,4,5496,2943.94,52.91
456215,8155,8055,12,100,6545.36,4562.15
105318,13321,13271,4,50,1066.29,2106.36
444030,8814,21708,4,-12894,4495.59,
427177,18125,15819,8,2306,5182.84,185.25
126077,8216,12369,12,-4153,1808.84,
402618,29603,12283,12,17320,5776.4,23.25
183515,7113,16171,12,-9058,2632.91,
256988,25740,8774,8,16966,3117.97,15.15
385463,15238,9519,8,5719,4676.73,67.4
175885,18760,13983,8,4777,2133.97,36.82
421921,26927,21133,8,5794,5119.07,72.82
67368,25939,17939,8,8000,817.36,8.42
196400,17588,3781,12,13807,2817.77,14.22
238014,28446,19282,4,9164,2409.78,25.97
141751,8374,9823,12,-1449,2033.72,
280203,11430,21489,4,-10059,2836.92,
339450,24850,23251,8,1599,4118.47,212.29
220987,24465,10193,4,14272,2237.39,15.48
349363,16970,24360,12,-7390,5012.34,
261951,5629,5113,12,516,3758.24,507.66
245716,21653,19280,4,2373,2487.76,103.55
110279,15831,16565,8,-734,1337.99,
365172,10724,23354,8,-12630,4430.54,
416407,27281,13183,12,14098,5974.23,29.54
50126,16083,20961,4,-4878,507.5,
364473,18149,12203,8,5946,4422.06,61.3
77632,24816,21658,8,3158,941.89,24.58
246382,14472,24253,12,-9781,3534.87,
159945,11276,18795,8,-7519,1940.57,
367320,20635,21810,4,-1175,3718.94,
300869,10895,16489,12,-5594,4316.6,
267138,18994,8546,12,10448,3832.65,25.57
225399,28499,9852,4,18647,2282.06,12.09
184869,28040,5551,12,22489,2652.33,8.22
228954,15552,9411,8,6141,2777.84,37.28
194790,21959,19391,8,2568,2363.34,75.85
84560,28413,21939,4,6474,856.13,13.06
388733,11099,3475,8,7624,4716.4,50.99
334260,14499,24800,4,-10301,3384.22,
479460,24576,13403,4,11173,4854.3,42.91
182717,8178,10239,8,-2061,2216.86,
228595,27436,9710,4,17726,2314.41,12.9
174085,24118,24384,8,-266,2112.13,
429862,11116,24038,12,-12922,6167.27,
331400,20563,11078,12,9485,4754.63,34.94
150158,8568,5285,4,3283,1520.28,45.74
234245,14847,8223,8,6624,2842.04,35.36
218502,19135,16521,8,2614,2651.03,83.59
482498,23587,17889,12,5698,6922.44,84.68
431863,22774,9971,12,12803,6195.98,33.73
380388,6742,22909,8,-16167,4615.16,
192766,23309,14531,4,8778,1951.66,21.96
368408,5619,17721,12,-12102,5285.58,
107545,22658,22206,4,452,1088.84,237.93
351368,22340,7943,4,14397,3557.43,24.41
410089,6939,9530,12,-2591,5883.59,
63224,25337,14116,4,11221,640.11,5.63
90738,21001,3258,4,17743,918.68,5.11
468366,5968,3282,8,2686,5682.57,174.37
375875,19846,16937,4,2909,3805.55,129.21
230760,5281,4898,8,383,2799.76,602.51
289690,20360,7135,12,13225,4156.21,21.9
189649,11262,9629,12,1633,2720.91,116.14
58070,6058,14168,8,-8110,704.55,
176161,25677,22584,12,3093,2527.4,56.95
58666,15724,24494,4,-8770,593.96,
369905,10178,3612,4,6566,3745.11,56.34
348512,11980,17203,4,-5223,3528.51,
187855,14200,20071,12,-5871,2695.17,
91914,6229,23074,4,-16845,930.58,
251579,25969,5307,12,20662,3609.43,12.18
177738,13467,10133,4,3334,1799.51,53.31
296965,24124,14205,8,9919,3603.0,29.94
379670,7289,8906,12,-1617,5447.16,
488981,6239,5591,12,648,7015.46,754.6
332100,10370,18149,4,-7779,3362.35,
268967,21170,15150,12,6020,3858.9,44.68
358384,5125,10183,12,-5058,5141.77,
433152,17504,24632,8,-7128,5255.33,
480364,28857,13102,8,15755,5828.14,30.49
144270,20398,24492,4,-4094,1460.66,
316901,26726,22988,8,3738,3844.88,84.78
69097,28735,20053,4,8682,699.57,7.96
191467,11638,23748,4,-12110,1938.51,
197313,11570,4283,4,7287,1997.7,27.08
416036,8249,3923,12,4326,5968.91,96.17
208768,14110,4125,8,9985,2532.93,20.91
296726,12595,4529,4,8066,3004.21,36.79
382624,18605,11438,8,7167,4642.28,53.39
96163,17115,23095,4,-5980,973.6,
69816,11294,19154,8,-7860,847.06,
493056,27911,11004,8,16907,5982.13,29.16
283619,10757,12752,4,-1995,2871.5,
364997,17595,13592,12,4003,5236.65,91.18
205989,6969,6864,8,105,2499.21,1961.8
146731,15985,3226,12,12759,2105.16,11.5
202638,22275,18036,12,4239,2907.27,47.8
256524,9470,14739,4,-5269,2597.18,
112823,28559,19648,4,8911,1142.28,12.66
201878,15225,12587,4,2638,2043.92,76.53
256592,14556,14749,8,-193,3113.17,
51759,29704,3645,4,26059,524.03,1.99
307164,14206,19299,4,-5093,3109.89,
485165,14991,24953,8,-9962,5886.39,
404518,28196,22374,8,5822,4907.92,69.48
183554,12519,16675,4,-4156,1858.4,
336586,18669,21888,4,-3219,3407.77,
476935,9612,13964,4,-4352,4828.73,
143501,17373,19087,4,-1714,1452.88,
314223,22582,16537,12,6045,4508.19,51.98
445933,20552,16269,12,4283,6397.84,104.12
109676,19646,12346,4,7300,1110.42,15.02
471168,10238,3587,12,6651,6759.89,70.84
267516,20577,15763,8,4814,3245.71,55.57
223532,27473,12177,12,15296,3207.03,14.61
140397,27641,7079,12,20562,2014.29,6.83
122847,20504,6348,4,14156,1243.77,8.68
143607,29089,23215,12,5874,2060.34,24.45
270178,8719,21099,12,-12380,3876.27,
199521,5302,13785,12,-8483,2862.55,
476752,17144,15328,12,1816,6840.01,262.53
114077,22370,9450,8,12920,1384.07,8.83
350402,15055,16230,4,-1175,3547.65,
229374,9440,8433,4,1007,2322.3,227.78
307009,26293,4098,8,22195,3724.87,13.83
472081,8072,10096,12,-2024,6772.99,
187717,18598,21710,8,-3112,2277.53,
431915,19287,14439,12,4848,6196.73,89.09
88000,18965,12087,8,6878,1067.68,12.79
76737,24508,19021,4,5487,776.92,13.99
323629,14519,9416,4,5103,3276.59,63.42
350709,18380,9980,4,8400,3550.76,41.75
468738,16865,21058,12,-4193,6725.03,
431758,13125,14101,12,-976,6194.47,
377299,8291,10950,8,-2659,4577.68,
236240,9033,12122,8,-3089,2866.24,
102487,10105,15576,4,-5471,1037.63,
442092,22087,4089,12,17998,6342.74,24.56
324486,13133,7578,8,5555,3936.91,58.41
352950,21958,12127,12,9831,5063.81,35.9
360914,10704,13487,12,-2783,5178.07,
128623,12848,3155,4,9693,1302.25,13.27
415321,26592,4958,4,21634,4204.92,19.2
443170,17975,13693,12,4282,6358.2,103.5
387773,11924,9344,12,2580,5563.42,150.3
433137,25212,8779,12,16433,6214.26,26.36
233675,24614,24447,12,167,3352.56,1399.25
439088,5488,6830,4,-1342,4445.55,
263046,12114,12046,8,68,3191.47,3868.32
155947,20740,12794,4,7946,1578.89,19.63
338543,8173,3441,8,4732,4107.46,71.54
178177,6667,17478,12,-10811,2556.32,
266454,9114,7628,8,1486,3232.82,179.31
159575,8553,9370,4,-817,1615.62,
423048,12761,12528,4,233,4283.16,1815.66
257606,6000,20332,12,-14332,3695.9,
498322,20638,14565,4,6073,5045.27,82.06
342822,22772,11179,12,11593,4918.5,29.57
126218,10450,19013,4,-8563,1277.9,
113230,8712,19843,4,-11131,1146.4,
295756,6367,24030,12,-17663,4243.24,
386199,13189,3392,8,9797,4685.66,39.42
499589,14013,15130,4,-1117,5058.1,
212552,21838,21171,8,667,2578.84,318.67
384402,24156,13449,4,10707,3891.88,35.9
89986,8726,20522,4,-11796,911.06,
205232,28616,24125,4,4491,2077.87,45.7
397739,9806,10418,4,-612,4026.91,
151358,7190,5454,8,1736,1836.39,87.19
377073,14108,23058,8,-8950,4574.94,
123506,17178,20761,4,-3583,1250.44,
84911,7875,18223,4,-10348,859.68,
399271,10592,9701,8,891,4844.26,448.12
475037,22824,5597,12,17227,6815.4,27.58
256111,17592,3141,12,14451,3674.45,17.72
425597,13927,5659,8,8268,5163.67,51.48
134458,27443,23980,4,3463,1361.32,38.83
62175,19437,12031,4,7406,629.49,8.4
431379,16530,18037,12,-1507,6189.04,
366915,12010,16970,12,-4960,5264.16,
439301,16207,8661,8,7546,5329.93,58.22
171300,28501,9142,12,19359,2457.66,8.85
136925,7989,15109,8,-7120,1661.28,
294446,17040,11787,12,5253,4224.44,56.05
116358,14218,13096,12,1122,1669.4,103.71
460543,27612,11472,12,16140,6607.45,28.53
97057,11471,19807,4,-8336,982.65,
318294,7863,7249,4,614,3222.57,518.39
316569,15693,17949,4,-2256,3205.11,
304726,6177,4750,12,1427,4371.93,213.54
328176,9760,24141,8,-14381,3981.68,
52198,5011,21351,8,-16340,633.31,
234466,26636,7088,8,19548,2844.72,11.99
463295,21353,23562,8,-2209,5621.05,
217292,25783,18282,4,7501,2199.98,28.97
485090,16556,22330,4,-5774,4911.3,
194931,16563,12641,12,3922,2796.69,49.7
493676,19051,24778,12,-5727,7082.82,
212491,16022,8075,8,7947,2578.1,26.74
431009,13234,13412,4,-178,4363.76,
451921,26829,18686,8,8143,5483.05,55.5
486096,21173,10230,12,10943,6974.07,44.42
310910,18178,18432,12,-254,4460.66,
73236,11570,14002,8,-2432,888.55,
137955,29596,16947,12,12649,1979.25,10.91
266586,5406,16686,8,-11280,3234.42,
153145,14206,20915,4,-6709,1550.52,
196430,9431,16074,8,-6643,2383.24,
280785,26627,22374,4,4253,2842.81,66.02
144914,11542,7493,4,4049,1467.18,35.79
415014,28320,20317,12,8003,5954.25,51.86
257990,13906,4460,12,9446,3701.41,27.31
428387,9146,17140,12,-7994,6146.11,
64596,17046,22107,8,-5061,783.73,
476788,17611,13704,8,3907,5784.75,122.03
182351,18076,19669,12,-1593,2616.21,
244269,21524,19648,8,1876,2963.66,130.21
423640,9882,9816,12,66,6078.0,6418.79
442417,19113,14639,8,4474,5367.74,98.89
188155,18645,17424,4,1221,1904.98,154.1
170674,11012,16965,4,-5953,1727.99,
432451,22347,21146,12,1201,6204.42,360.08
307529,12151,14240,8,-2089,3731.18,
290469,29948,3040,8,26908,3524.19,10.79
460987,8610,8827,4,-217,4667.27,
473191,14884,11259,4,3625,4790.83,130.54
488864,11894,20371,12,-8477,7013.78,
306713,18467,17849,4,618,3105.32,496.3
491501,28695,19232,12,9463,7051.61,51.94
69063,21489,10804,4,10685,699.23,6.46
117642,26923,22582,4,4341,1191.07,27.1
140093,14873,8374,8,6499,1699.71,21.56
267215,17289,24174,4,-6885,2705.42,
480815,17208,5524,4,11684,4868.02,41.15
232992,15828,12277,12,3551,3342.76,65.61
209601,28171,21863,4,6308,2122.11,33.23
85954,7137,12885,12,-5748,1233.19,
77856,25829,24538,4,1291,788.25,60.31
52573,24914,3778,4,21136,532.28,2.49
85367,6286,4492,12,1794,1224.77,47.58
287804,20710,20044,8,666,3491.86,432.14
411752,16371,20732,12,-4361,5907.44,
372918,20945,16615,12,4330,5350.29,86.12
73752,12052,15132,12,-3080,1058.13,
367173,8654,13178,8,-4524,4454.82,
198757,28486,10851,4,17635,2012.32,11.27
442426,23743,19288,12,4455,6347.53,99.31
363837,20600,10156,12,10444,5220.0,34.84
166739,29489,5044,8,24445,2023.0,6.82
368105,13636,10368,12,3268,5281.24,112.64
288009,11441,22900,4,-11459,2915.95,
306028,26431,16635,8,9796,3712.96,31.24
257980,29611,12168,4,17443,2611.92,14.79
306609,26587,23961,4,2626,3104.27,116.76
438822,14667,20111,8,-5444,5324.12,
386676,17149,14328,12,2821,5547.68,137.07
394138,6798,16319,4,-9521,3990.46,
368277,14600,3342,4,11258,3728.63,32.71
373412,26675,4447,4,22228,3780.61,16.8
481459,10495,9581,4,914,4874.54,526.76
238456,14900,14851,8,49,2893.13,4866.45
81653,18673,9317,8,9356,990.68,8.73
207729,16130,19910,4,-3780,2103.16,
483168,27668,13088,12,14580,6932.06,33.14
465396,20222,15946,4,4276,4711.91,108.84
278504,28669,19789,12,8880,3995.72,31.36
171829,6300,17567,4,-11267,1739.69,
178377,28253,17868,12,10385,2559.19,17.18
51622,14435,12765,4,1670,522.65,30.91
98756,24481,23124,12,1357,1416.86,72.78
90809,9616,15466,4,-5850,919.4,
66725,21393,21230,4,163,675.56,409.36
242468,15617,20862,12,-5245,3478.71,
101226,10752,13587,8,-2835,1228.15,
131182,14852,3771,12,11081,1882.08,11.84
79402,11295,24909,8,-13614,963.37,
54263,26199,19300,4,6899,549.39,7.87
277595,22456,11770,12,10686,3982.68,25.98
227900,8225,14093,12,-5868,3269.7,
97924,6316,16803,12,-10487,1404.92,
386326,27083,3193,8,23890,4687.2,16.17
274137,17337,5007,8,12330,3326.04,22.23
454880,11807,20569,4,-8762,4605.44,
347881,28058,21778,8,6280,4220.76,55.4
413476,8683,14190,8,-5507,5016.6,
401707,12227,12984,4,-757,4067.09,
210445,8273,12302,12,-4029,3019.27,
217469,28384,23389,12,4995,3120.05,43.54
440719,5145,10429,4,-5284,4462.07,
151371,10010,5261,12,4749,2171.73,31.87
88709,21035,23120,8,-2085,1076.28,
242192,8040,9716,4,-1676,2452.08,
200322,14654,24259,4,-9605,2028.16,
71172,21866,11921,4,9945,720.58,7.16
61555,24563,7378,12,17185,883.14,3.58
103276,22633,10815,4,11818,1045.62,8.74
107492,22014,16778,4,5236,1088.3,20.53
234074,19996,22835,4,-2839,2369.89,
306010,21336,15728,12,5608,4390.35,54.57
401743,13853,13332,8,521,4874.25,771.1
272320,16695,12836,4,3859,2757.11,70.57
467978,7852,5800,8,2052,5677.86,228.06
61046,21014,11333,12,9681,875.83,6.31
278071,5987,8410,12,-2423,3989.51,
428165,12622,20839,12,-8217,6142.92,
471985,28711,8808,12,19903,6771.61,23.71
234374,14160,9796,8,4364,2843.6,53.71
466366,22484,24180,4,-1696,4721.73,
316997,11652,24477,12,-12825,4547.99,
170900,12421,13288,12,-867,2451.92,
465008,26400,20709,8,5691,5641.83,81.71
109129,5769,24360,8,-18591,1324.04,
287091,22727,20543,12,2184,4118.92,131.45
255550,19114,7650,4,11464,2587.32,22.29
294883,9358,7987,4,1371,2985.55,215.09
164130,28164,18200,12,9964,2354.79,16.47
475203,27986,7697,8,20289,5765.52,23.42
196922,16543,19724,12,-3181,2825.26,
455328,23733,6828,12,16905,6532.63,26.93
171789,10699,21352,8,-10653,2084.27,
205130,22625,20087,12,2538,2943.02,80.82
226492,6125,15605,12,-9480,3249.5,
88890,15793,8482,12,7311,1275.31,12.16
116017,11764,21184,8,-9420,1407.61,
228376,26485,8463,4,18022,2312.2,12.67
213993,17323,16860,4,463,2166.58,462.19
182596,18031,7912,8,10119,2215.39,18.04
150424,19052,7648,4,11404,1522.97,13.19
327192,17640,3855,12,13785,4694.25,23.74
478327,12843,5866,4,6977,4842.83,68.56
218976,19210,14834,12,4376,3141.67,50.04
367056,21456,19294,4,2162,3716.26,169.78
84008,26856,19566,8,7290,1019.25,11.52
443276,15106,6112,4,8994,4487.95,49.29
255738,10189,7492,4,2697,2589.22,94.82
133559,7472,18114,4,-10642,1352.22,
105337,22091,4517,8,17574,1278.03,5.99
422760,23188,19018,4,4170,4280.24,101.38
325494,11704,24386,8,-12682,3949.14,
74354,8713,20740,12,-12027,1066.76,
95186,10051,23013,4,-12962,963.71,
78145,15756,23012,8,-7256,948.11,
477236,7475,14431,8,-6956,5790.19,
136123,8610,11210,4,-2600,1378.18,
256258,9255,14595,12,-5340,3676.56,
266541,19484,15871,8,3613,3233.88,73.77
70581,28781,15743,4,13038,714.6,5.41
138929,6735,12324,12,-5589,1993.23,
335195,13258,14531,8,-1273,4066.84,
101474,12979,9588,8,3391,1231.16,29.92
141748,7428,6311,12,1117,2033.67,126.9
175995,17345,3987,12,13358,2525.02,13.18
295690,12426,6321,4,6105,2993.72,48.43
381770,13533,18812,4,-5279,3865.24,
319104,10249,7615,8,2634,3871.61,121.15
478988,26675,18512,12,8163,6872.09,58.68
464736,24201,16146,12,8055,6667.61,57.7
230553,25258,16654,12,8604,3307.77,26.8
86408,14686,23125,8,-8439,1048.37,
406150,19109,6052,12,13057,5827.07,31.11
309568,25595,3726,12,21869,4441.4,14.16
369278,5661,6760,8,-1099,4480.36,
201563,17075,4875,4,12200,2040.73,16.52
182413,19788,16969,4,2819,1846.84,64.71
225695,15060,7033,8,8027,2738.3,28.12
140327,20836,8443,12,12393,2013.28,11.32
443554,15526,20373,8,-4847,5381.53,
252503,8374,6744,4,1630,2556.47,154.91
193326,5207,19977,4,-14770,1957.33,
232932,7665,4774,8,2891,2826.11,80.57
61344,23877,13651,8,10226,744.27,6.0
444966,28197,3935,4,24262,4505.06,18.34
497972,5632,16395,8,-10763,6041.77,
117957,8083,6808,4,1275,1194.26,92.52
155423,18711,19715,8,-1004,1885.71,
370197,15123,14641,8,482,4491.51,768.04
196968,25103,22086,8,3017,2389.77,65.29
236833,12123,17376,4,-5253,2397.82,
243624,15754,8889,8,6865,2955.83,35.49
301147,6679,8054,4,-1375,3048.97,
127454,20901,6868,4,14033,1290.41,9.08
307594,5236,23584,8,-18348,3731.96,
402744,12446,19585,8,-7139,4886.4,
434876,9443,21881,4,-12438,4402.91,
471151,28154,4842,4,23312,4770.17,20.21
87641,20463,13058,12,7405,1257.39,11.84
79711,27483,12101,4,15382,807.04,5.18
382486,13555,15497,12,-1942,5487.56,
419040,23752,7658,12,16094,6012.01,26.04
193254,21669,14381,12,7288,2772.63,26.52
137833,5148,10544,8,-5396,1672.29,
368420,18395,10718,8,7677,4469.95,47.99
331685,25421,16851,4,8570,3358.15,38.7
406601,27933,20154,12,7779,5833.54,52.27
94813,28505,22539,8,5966,1150.34,15.89
218270,9895,14777,8,-4882,2648.22,
189892,26664,4628,8,22036,2303.91,8.62
336214,22396,3386,8,19010,4079.2,17.69
454338,16023,9031,8,6992,5512.37,64.98
392703,15699,9439,12,6260,5634.15,62.73
254615,14715,16392,12,-1677,3652.99,
91786,24169,23392,12,777,1316.86,118.13
276006,25109,21850,12,3259,3959.88,84.69
280876,21163,5282,4,15881,2843.73,17.69
449953,25960,4856,12,21104,6455.52,21.32
348206,10782,18670,8,-7888,4224.7,
497453,27641,4998,12,22643,7137.01,21.97
363715,23792,8476,4,15316,3682.44,23.75
337654,21724,12428,8,9296,4096.67,36.32
331570,7817,7669,12,148,4757.07,2240.34
87265,20096,15336,12,4760,1252.0,18.33
461066,23880,12342,12,11538,6614.96,39.96
299321,27346,23702,8,3644,3631.59,82.14
116150,10299,10064,8,235,1409.22,494.26
137312,14917,10446,4,4471,1390.22,30.71
139613,28958,20815,8,8143,1693.89,17.15
387054,23073,8624,8,14449,4696.03,26.79
364519,8267,10461,12,-2194,5229.79,
171826,9406,4819,8,4587,2084.72,37.46
85435,29837,13516,12,16321,1225.74,5.23
408587,22826,16749,12,6077,5862.04,67.23
260017,29981,20514,8,9467,3154.72,27.47
184055,15382,5658,4,9724,1863.47,18.93
201734,9437,6500,4,2937,2042.46,68.69
335654,10435,5120,8,5315,4072.41,63.15
259259,29819,7020,4,22799,2624.87,11.37
222070,9107,13213,12,-4106,3186.06,
144071,5560,6259,12,-699,2067.0,
318784,17329,13081,8,4248,3867.73,75.04
356691,26932,4823,4,22109,3611.32,16.13
366764,6826,20858,4,-14032,3713.31,
196389,16421,21626,12,-5205,2817.61,
165608,17265,16467,8,798,2009.28,207.53
319708,12629,22627,4,-9998,3236.89,
208417,13325,9990,8,3335,2528.67,62.49
163824,24522,24544,4,-22,1658.64,
304444,12693,6134,12,6559,4367.89,46.42
129273,13264,21454,12,-8190,1854.69,
387003,17686,19743,8,-2057,4695.41,
261837,18716,18434,12,282,3756.6,928.5
160017,29226,18007,4,11219,1620.09,14.26
173618,11721,13233,12,-1512,2490.91,
495609,28386,19378,8,9008,6013.1,55.02
175341,25609,4141,8,21468,2127.37,8.17
341574,24362,21019,8,3343,4144.24,102.18
256604,12373,23384,4,-11011,2597.99,
77788,10907,13135,4,-2228,787.57,
276577,27481,15966,4,11515,2800.21,24.02
491759,21127,6361,4,14766,4978.82,33.3
457135,10656,10835,4,-179,4628.27,
381490,13984,14172,12,-188,5473.27,
408266,25643,19390,4,6253,4133.49,65.29
89974,13286,6267,4,7019,910.94,12.82
419453,10901,9564,12,1337,6017.93,313.73
66371,9917,24312,4,-14395,671.97,
357228,13429,21990,8,-8561,4334.16,
472845,19716,14411,4,5305,4787.33,89.13
232256,20795,8906,4,11889,2351.48,19.54
374060,16138,19028,8,-2890,4538.38,
123972,7530,22657,8,-15127,1504.12,
243259,23344,10611,8,12733,2951.4,19.1
325128,28429,20297,8,8132,3944.7,39.98
345183,22432,5011,4,17421,3494.81,19.81
135431,10772,20826,8,-10054,1643.15,
395835,20476,24930,8,-4454,4802.57,
370750,23913,14246,12,9667,5319.19,38.35
453832,20751,16790,8,3961,5506.23,114.58
414809,7964,14738,8,-6774,5032.78,
155373,12137,17730,12,-5593,2229.15,
231144,22347,14120,12,8227,3316.24,28.1
336718,21920,21213,4,707,3409.11,476.26
446646,18891,11767,12,7124,6408.07,62.7
300195,12340,16703,4,-4363,3039.33,
193748,28563,3929,12,24634,2779.72,7.87
454032,12967,14951,12,-1984,6514.04,
82733,17415,23083,4,-5668,837.63,
266752,16871,18845,12,-1974,3827.12,
52050,16916,20438,4,-3522,526.98,
159996,13734,18747,12,-5013,2295.48,
83933,5845,8744,8,-2899,1018.34,
74951,27161,21284,12,5877,1075.33,12.75
82413,24420,12649,4,11771,834.39,7.0
215873,27331,9980,12,17351,3097.15,12.44
236691,7494,10069,4,-2575,2396.38,
476129,17677,12591,4,5086,4820.57,93.62
424717,24103,22799,8,1304,5152.99,325.7
483816,23268,3442,8,19826,5870.02,24.4
238847,17330,7652,4,9678,2418.21,24.68
271888,25733,12370,12,13363,3900.8,20.35
311044,10179,10597,4,-418,3149.17,
271165,11610,17325,4,-5715,2745.41,
293662,11430,7458,12,3972,4213.2,73.93
216472,12154,9591,12,2563,3105.74,84.46
447710,18828,19346,12,-518,6423.34,
261760,15145,14826,12,319,3755.5,820.56
172744,11488,21693,4,-10205,1748.95,
401575,26121,17138,4,8983,4065.75,44.7
255763,27909,20294,8,7615,3103.11,33.59
93001,8850,23724,4,-14874,941.59,
117364,22073,23393,12,-1320,1683.83,
437132,18564,5169,8,13395,5303.62,32.63
357172,26559,21556,12,5003,5124.38,71.39
288506,10078,9313,4,765,2920.98,377.13
278731,17168,11315,8,5853,3381.78,47.62
480789,10448,11036,12,-588,6897.93,
181878,22563,3785,8,18778,2206.68,9.69
436487,14074,9139,8,4935,5295.79,88.45
237710,11406,9344,4,2062,2406.7,115.28
178301,29975,21800,12,8175,2558.1,21.81
438439,28291,23538,8,4753,5319.47,92.24
210829,13800,17973,8,-4173,2557.94,
84636,19083,8619,12,10464,1214.28,8.09
261169,6638,4936,8,1702,3168.7,153.45
229352,27055,6807,8,20248,2782.67,11.33
336406,28312,10151,8,18161,4081.53,18.52
392579,15340,12493,12,2847,5632.37,137.89
243283,6382,15355,12,-8973,3490.4,
498058,6403,6236,12,167,7145.69,2982.38
440727,14011,18848,12,-4837,6323.15,
295596,8292,5352,4,2940,2992.77,100.54
481413,14011,4932,8,9079,5840.87,53.02
353988,5419,13913,12,-8494,5078.7,
376898,17411,11556,8,5855,4572.81,64.37
477373,9517,24300,8,-14783,5791.85,
389273,24686,8498,4,16188,3941.2,24.05
352186,29241,13582,12,15659,5052.85,22.49
111665,20422,20330,12,92,1602.07,1213.75
296584,14700,16865,8,-2165,3598.38,
166953,29254,12569,12,16685,2395.29,10.01
208448,10693,20823,8,-10130,2529.05,
236626,5767,7857,8,-2090,2870.93,
195271,23428,3340,4,20088,1977.02,9.72
168533,19818,14181,4,5637,1706.31,29.9
494164,6549,19766,4,-13217,5003.17,
123781,14956,11491,8,3465,1501.81,35.72
116262,11140,3138,12,8002,1668.02,14.53
358744,15837,3358,4,12479,3632.11,28.75
126898,8716,24315,12,-15599,1820.62,
199369,9481,12714,4,-3233,2018.51,
80448,29282,22840,4,6442,814.5,12.49
338316,11548,4627,8,6921,4104.71,48.88
486090,23677,18996,4,4681,4921.42,103.84
57657,9837,8004,4,1833,583.75,31.45
306689,12758,16283,8,-3525,3720.98,
468641,15900,9652,12,6248,6723.64,75.01
469901,28177,22554,4,5623,4757.52,83.57
424999,29022,23219,8,5803,5156.41,73.24
467794,12993,5151,4,7842,4736.19,59.65
209903,27391,12429,8,14962,2546.7,14.03
57906,10542,17072,12,-6530,830.78,
373557,27740,14927,12,12813,5359.46,29.15
104028,29817,9905,8,19912,1262.15,5.22
319431,19828,22218,8,-2390,3875.58,
345804,28764,15452,8,13312,4195.56,25.98
372648,21052,19212,12,1840,5346.42,202.53
240792,7385,21951,4,-14566,2437.9,
152979,19308,4307,12,15001,2194.8,10.2
84701,25652,17852,8,7800,1027.66,10.86
133300,5671,5660,8,11,1617.3,12118.18
291249,5163,13403,12,-8240,4178.58,
198746,13656,23114,8,-9458,2411.34,
133560,16234,13238,12,2996,1916.2,44.58
292615,25976,9207,8,16769,3550.23,17.45
467090,9795,22546,4,-12751,4729.06,
93642,15634,4140,4,11494,948.08,8.15
377304,9798,4708,8,5090,4577.74,74.13
329746,27420,6630,12,20790,4730.9,15.86
415464,23739,22595,4,1144,4206.37,363.17
138801,27271,13485,12,13786,1991.39,10.07
338075,29345,15021,8,14324,4101.78,23.6
144377,15749,19859,12,-4110,2071.39,
341336,10827,10684,4,143,3455.86,2386.97
358686,9719,4207,12,5512,5146.1,65.07
439159,5593,16331,12,-10738,6300.66,
354664,26223,4960,8,21263,4303.05,16.68
376916,12394,3557,8,8837,4573.03,42.65
362250,19056,18883,8,173,4395.09,2093.93
131121,24877,16893,4,7984,1327.54,16.42
75559,27548,3882,4,23666,765.0,3.19
417739,15636,7761,8,7875,5068.33,53.05
83742,24056,8867,8,15189,1016.02,5.51
381813,25584,15869,4,9715,3865.67,39.3
202826,5016,10166,4,-5150,2053.51,
185044,8191,15982,4,-7791,1873.48,
382975,5392,10929,4,-5537,3877.44,
162217,11272,8347,8,2925,1968.14,55.46
91873,21955,10269,4,11686,930.17,7.86
418676,8631,16527,8,-7896,5079.7,
438411,11172,5454,12,5718,6289.92,76.67
453119,14312,23878,12,-9566,6500.94,
184092,28561,21330,4,7231,1863.84,25.46
353899,29817,15991,12,13826,5077.42,25.6
398100,25281,5808,12,19473,5711.58,20.44
136988,29507,9642,12,19865,1965.38,6.9
95648,23663,6825,4,16838,968.39,5.68
175991,28835,6536,4,22299,1781.82,7.89
452732,13906,18309,12,-4403,6495.39,
427149,22159,6802,8,15357,5182.5,27.81
52396,28253,24083,12,4170,751.73,12.56
134082,23631,21354,4,2277,1357.52,58.89
462345,28472,9142,4,19330,4681.02,23.92
178322,21462,22203,4,-741,1805.42,
182663,13080,12094,12,986,2620.68,185.26
61303,12099,3364,8,8735,743.77,7.02
211633,25310,23642,4,1668,2142.68,126.88
383863,28724,22503,4,6221,3886.43,61.7
299690,19916,18688,12,1228,4299.68,244.05
309820,12083,4863,8,7220,3758.97,42.91
149616,27614,19499,12,8115,2146.55,18.44
436309,14223,10084,4,4139,4417.42,105.41
136231,9940,11016,8,-1076,1652.86,
319458,24655,5384,8,19271,3875.91,16.58
69623,8456,18072,4,-9616,704.9,
248747,12788,6935,8,5853,3017.99,42.5
155228,29983,16127,8,13856,1883.34,11.2
476346,29034,17482,12,11552,6834.18,41.23
232828,7711,10742,4,-3031,2357.27,
409768,16280,19165,4,-2885,4148.7,
207364,23052,24826,4,-1774,2099.46,
423929,21531,5490,4,16041,4292.08,26.43
398350,27804,16324,4,11480,4033.1,34.7
119274,17089,21108,8,-4019,1447.12,
183541,15142,22151,12,-7009,2633.28,
103947,21749,4137,4,17612,1052.41,5.9
203606,20587,23501,12,-2914,2921.15,
244692,14866,6420,12,8446,3510.62,28.97
98874,9531,8845,8,686,1199.61,144.13
99708,17686,24162,4,-6476,1009.5,
124553,10330,6906,8,3424,1511.17,36.38
118344,10510,23021,4,-12511,1198.18,
361282,13964,22337,8,-8373,4383.35,
235374,11493,15413,12,-3920,3376.93,
97638,15759,3276,4,12483,988.54,7.82
128249,10439,21383,12,-10944,1840.0,
418009,19473,20611,12,-1138,5997.21,
52719,14765,9337,8,5428,639.63,9.71
203962,18279,14944,4,3335,2065.02,61.16
479725,11511,23119,12,-11608,6882.66,
92534,16483,18906,8,-2423,1122.69,
142241,28888,20079,4,8809,1440.12,16.15
462003,22630,23536,4,-906,4677.56,
176209,25223,15306,12,9917,2528.09,17.77
492061,29935,13503,4,16432,4981.88,29.95
239004,7376,22225,12,-14849,3429.01,
142124,24393,7208,4,17185,1438.94,8.27
141659,16824,14590,8,2234,1718.71,63.41
214134,23211,13886,12,9325,3072.2,22.96
125713,11979,15866,12,-3887,1803.62,
268335,14832,4088,4,10744,2716.76,24.98
125418,17504,6363,4,11141,1269.8,11.26
178232,29953,3024,12,26929,2557.11,6.62
478048,25669,12764,4,12905,4840.0,37.04
213038,11910,23620,8,-11710,2584.74,
456203,29945,12959,4,16986,4618.83,26.86
218383,19089,15935,8,3154,2649.59,69.24
343719,7196,11068,8,-3872,4170.26,
375996,25131,21619,8,3512,4561.87,107.06
308722,10978,10295,8,683,3745.65,452.01
182079,26991,11392,8,15599,2209.12,11.67
252053,22153,14390,4,7763,2551.91,32.47
126242,5780,11448,8,-5668,1531.66,
228589,14908,23131,4,-8223,2314.35,
79257,11303,13433,8,-2130,961.61,
485423,19686,18038,12,1648,6964.41,294.55
194353,8983,22559,8,-13576,2358.04,
373390,14503,14528,12,-25,5357.06,
313579,21905,24281,8,-2376,3804.58,
279947,18070,24421,8,-6351,3396.53,
281758,28953,18743,8,10210,3418.5,27.6
141357,17232,11605,12,5627,2028.06,25.12
207732,27168,5014,12,22154,2980.35,9.38
448300,9583,4381,8,5202,5439.12,86.18
456723,10946,4098,4,6848,4624.1,66.69
253667,26325,22810,8,3515,3077.68,72.17
133807,27651,23039,12,4612,1919.74,29.01
488755,21377,12101,8,9276,5929.95,52.69
428097,12128,3187,12,8941,6141.95,47.88
188563,16889,14948,12,1941,2705.33,97.15
308778,17275,13207,12,4068,4430.07,75.9
231264,7461,24793,8,-17332,2805.87,
435941,19291,5092,12,14199,6254.49,30.7
376032,19036,21514,12,-2478,5394.97,
123609,16435,8242,8,8193,1499.72,15.09
321221,5685,11549,12,-5864,4608.59,
298512,23544,8185,8,15359,3621.77,19.44
303973,28415,18271,12,10144,4361.13,29.97
333097,17258,8776,4,8482,3372.45,39.27
426826,26725,15449,4,11276,4321.41,37.85
380033,20990,10823,12,10167,5452.37,37.38
204893,21422,18717,4,2705,2074.44,75.75
480783,15736,10355,8,5381,5833.22,89.35
165374,9875,9465,4,410,1674.33,403.35
74860,22640,15737,12,6903,1074.02,10.84
202267,16182,20881,12,-4699,2901.94,
127475,29081,16324,8,12757,1546.62,9.99
399410,7196,13350,12,-6154,5730.37,
202499,12165,5555,8,6610,2456.87,30.64
412876,20997,24793,4,-3796,4180.17,
339227,19215,5951,4,13264,3434.51,25.58
268118,5301,20622,8,-15321,3253.01,
369516,28911,7727,8,21184,4483.25,17.44
173786,27765,23349,12,4416,2493.32,39.35
487280,22030,8686,4,13344,4933.47,36.52
57813,19571,6701,8,12870,701.43,4.49
81598,14951,5780,4,9171,826.14,8.9
307951,25714,20972,8,4742,3736.3,64.94
143106,15773,5368,4,10405,1448.88,13.75
339226,28387,18592,12,9795,4866.91,34.63
341385,21140,3436,4,17704,3456.36,19.28
277286,24921,5828,4,19093,2807.39,14.52
487785,18057,4556,4,13501,4938.59,36.13
61745,17500,16364,4,1136,625.14,54.35
338173,25942,18061,4,7881,3423.84,42.91
194097,27963,13576,12,14387,2784.73,13.49
282732,29858,19566,8,10292,3430.32,27.47
435539,20921,10190,4,10731,4409.62,40.59
195360,16870,8565,12,8305,2802.85,23.52
139186,9082,18369,4,-9287,1409.19,
449756,18718,24959,4,-6241,4553.56,
409912,25567,4589,8,20978,4973.36,19.54
263030,15517,3159,4,12358,2663.05,21.28
249950,8754,15145,12,-6391,3586.06,
91846,6724,18373,12,-11649,1317.72,
388076,6376,9555,8,-3179,4708.43,
198554,13706,19237,4,-5531,2010.26,
335555,13894,12203,12,1691,4814.24,198.44
494191,23037,11244,4,11793,5003.44,41.91
390941,23450,17743,4,5707,3958.09,68.5
364451,21406,16333,4,5073,3689.89,71.84
446309,23844,16341,8,7503,5414.96,59.48
334186,10926,21691,4,-10765,3383.47,
102930,11251,4228,12,7023,1476.75,14.66
298656,14496,8590,4,5906,3023.75,50.57
487629,28679,8585,12,20094,6996.06,24.27
294459,8300,12227,4,-3927,2981.25,
274695,27663,9046,12,18617,3941.08,14.76
410027,13553,15237,12,-1684,5882.7,
345900,28737,18649,4,10088,3502.07,34.29
103268,8727,7945,4,782,1045.54,132.06
482430,27656,10927,12,16729,6921.47,28.84
262943,27379,15641,8,11738,3190.22,22.4
308916,21898,18998,4,2900,3127.62,106.52
471818,21832,16386,8,5446,5724.45,86.64
234403,11019,10016,4,1003,2373.22,233.7
98901,20463,17027,4,3436,1001.32,28.78
412130,26727,18920,4,7807,4172.62,52.79
244488,15047,16752,4,-1705,2475.32,
213268,29417,24470,8,4947,2587.53,43.11
440530,16754,21268,4,-4514,4460.15,
317770,7520,21193,12,-13673,4559.08,
188496,8081,6167,12,1914,2704.37,98.48
325001,6428,14989,8,-8561,3943.16,
291531,8967,17087,4,-8120,2951.61,
296693,11445,5437,12,6008,4256.68,49.38
463198,19566,18275,8,1291,5619.87,358.79
445196,19042,8276,4,10766,4507.39,41.35
229362,16329,11859,12,4470,3290.68,51.31
76431,7159,10818,12,-3659,1096.56,
397120,10132,7728,8,2404,4818.16,165.19
288360,23931,22008,4,1923,2919.5,149.95
394855,24363,8738,4,15625,3997.71,25.27
76385,19933,23616,12,-3683,1095.9,
481374,15473,8793,12,6680,6906.32,72.06
466235,24033,7523,12,16510,6689.12,28.24
330783,29889,8571,4,21318,3349.02,15.52
135530,15805,19209,8,-3404,1644.35,
280983,8083,18246,8,-10163,3409.1,
333707,22421,13380,4,9041,3378.62,36.91
482557,18944,5224,8,13720,5854.75,35.17
427816,24873,11389,12,13484,6137.92,31.73
448992,12604,18927,8,-6323,5447.51,
479660,28928,14684,8,14244,5819.6,33.67
451927,20379,13640,8,6739,5483.12,67.06
255390,24018,11662,12,12356,3664.1,20.67
395114,8983,9361,4,-378,4000.34,
293373,6778,4948,12,1830,4209.05,160.31
397697,29286,15091,4,14195,4026.49,28.02
211779,10110,14992,4,-4882,2144.16,
220182,26573,9318,4,17255,2229.24,12.76
242860,17087,23180,8,-6093,2946.56,
132879,28762,15180,8,13582,1612.19,9.78
482043,22508,3234,4,19274,4880.45,25.01
288260,22081,18372,4,3709,2918.49,77.72
448871,7179,22991,8,-15812,5446.04,
357003,14596,3522,12,11074,5121.96,32.24
496841,10251,15718,4,-5467,5030.27,
364242,14235,24272,12,-10037,5225.81,
196323,23313,12821,8,10492,2381.94,18.71
172413,19871,8832,4,11039,1745.6,15.62
312670,6013,15820,12,-9807,4485.91,
380904,21610,19211,12,2399,5464.87,158.78
97837,28705,10122,12,18583,1403.68,5.26
310550,6828,8842,8,-2014,3767.83,
323680,12909,4316,8,8593,3927.13,37.67
78541,10588,16200,12,-5612,1126.84,
129083,18109,20508,12,-2399,1851.97,
494243,7023,24807,8,-17784,5996.53,
84531,26350,18206,12,8144,1212.77,10.38
320856,19537,21971,12,-2434,4603.35,
416245,10891,4378,8,6513,5050.2,63.91
377599,6080,22758,12,-16678,5417.45,
124744,10036,4519,12,5517,1789.71,22.61
302859,20379,10935,12,9444,4345.15,32.07
179749,15822,9093,8,6729,2180.85,26.71
317253,7563,8355,12,-792,4551.66,
361412,8292,24352,8,-16060,4384.92,
281809,8586,12083,8,-3497,3419.12,
366759,21087,8574,4,12513,3713.26,29.31
132503,21100,23456,4,-2356,1341.53,
304346,25815,16324,12,9491,4366.48,32.07
472975,28225,5257,8,22968,5738.49,20.59
135708,11643,16411,4,-4768,1373.98,
241184,8959,18233,12,-9274,3460.29,
152471,16005,18887,4,-2882,1543.69,
304225,15775,23808,4,-8033,3080.13,
207661,5161,22621,8,-17460,2519.5,
211087,21029,23277,8,-2248,2561.07,
210081,21977,5005,4,16972,2126.97,12.38
395453,19226,21400,4,-2174,4003.77,
438590,16154,13860,8,2294,5321.31,191.19
243118,17080,13070,12,4010,3488.04,60.63
418805,8390,12388,8,-3998,5081.26,
207215,10997,21156,4,-10159,2097.95,
56154,27738,23360,12,4378,805.65,12.83
202876,17693,21135,4,-3442,2054.02,
484904,22047,17609,12,4438,6956.96,109.26
114288,14324,19363,4,-5039,1157.11,
101195,5541,22604,12,-17063,1451.85,
332725,26817,19923,12,6894,4773.64,48.26
495864,10093,17823,4,-7730,5020.38,
342231,18428,20845,12,-2417,4910.02,
231002,16166,24568,8,-8402,2802.69,
214053,22251,11547,4,10704,2167.18,20.0
119298,21063,14515,8,6548,1447.41,18.22
358311,15258,3234,4,12024,3627.72,29.8
256376,21044,17562,12,3482,3678.25,73.63
486624,10469,20932,12,-10463,6981.64,
89499,11256,10480,12,776,1284.05,115.33
437960,15720,7213,4,8507,4434.13,51.48
495485,6169,13293,8,-7124,6011.6,
219631,5830,4673,8,1157,2664.73,189.83
295198,6651,5100,4,1551,2988.74,190.33
292997,22520,14849,4,7671,2966.45,38.2
146347,24194,23132,8,1062,1775.59,137.8
360931,14518,22557,8,-8039,4379.09,
347632,18258,21199,8,-2941,4217.74,
386585,21184,6841,8,14343,4690.34,26.95
255735,6019,13197,4,-7178,2589.19,
72431,26621,11016,4,15605,733.33,4.64
373825,15028,10011,12,5017,5363.3,74.51
244555,17448,7493,8,9955,2967.13,24.57
172720,17485,20058,12,-2573,2478.03,
99153,6283,11578,4,-5295,1003.88,
318512,22043,5158,4,16885,3224.78,18.86
470640,23394,22045,12,1349,6752.32,348.88
424504,29974,5064,8,24910,5150.4,17.04
226076,6733,6253,8,480,2742.93,470.99
269724,23509,24363,8,-854,3272.5,
424899,23555,15828,8,7727,5155.2,54.99
106985,29650,4401,12,25249,1534.92,4.24
362213,21230,22643,12,-1413,5196.7,
364470,19472,18193,4,1279,3690.08,284.96
158737,17889,15096,8,2793,1925.92,56.83
262133,8471,23307,8,-14836,3180.4,
204470,14028,7214,8,6814,2480.79,30.01
279465,27008,22611,12,4397,4009.51,63.56
100861,13329,14023,8,-694,1223.72,
388041,7097,14950,12,-7853,5567.26,
262977,19082,13704,8,5378,3190.64,48.9
177118,26452,13343,8,13109,2148.93,13.51
380721,18930,14867,4,4063,3854.62,93.7
246713,15077,5745,8,9332,2993.31,26.44
59078,11397,6866,8,4531,716.78,13.04
468219,7757,14956,4,-7199,4740.49,
374912,25304,8818,12,16486,5378.9,22.74
101047,29570,21606,12,7964,1449.73,12.69
383770,23284,19093,8,4191,4656.19,91.57
369804,23994,22176,12,1818,5305.61,203.41
285458,28284,18493,8,9791,3463.39,29.16
493002,22833,23447,4,-614,4991.41,
445141,10017,20908,4,-10891,4506.84,
265048,21370,11224,8,10146,3215.76,26.12
286293,12999,7025,4,5974,2898.58,47.92
167832,27436,21950,4,5486,1699.22,30.59
442550,15195,22187,8,-6992,5369.35,
175150,7096,23093,8,-15997,2125.05,
207087,20433,9155,4,11278,2096.66,18.36
83320,27788,16839,12,10949,1195.4,7.61
377025,15595,3719,12,11876,5409.21,31.75
140827,20941,17890,8,3051,1708.62,46.16
414359,24715,23963,8,752,5027.32,551.01
469505,20078,20356,12,-278,6736.03,
309931,28846,23102,4,5744,3137.9,53.96
446605,10105,23786,12,-13681,6407.48,
468899,24362,23936,12,426,6727.34,1100.7
456845,7839,21591,12,-13752,6554.4,
373694,8384,7426,12,958,5361.42,390.08
74826,15851,15512,8,339,907.85,220.73
150734,15053,18064,8,-3011,1828.82,
207702,18493,16767,4,1726,2102.88,120.34
279834,22069,14308,4,7761,2833.18,36.06
227235,19139,14477,4,4662,2300.64,48.74
148511,12531,15903,4,-3372,1503.6,
323797,9283,11680,12,-2397,4645.55,
209033,12736,5204,8,7532,2536.15,27.75
